msz 4 3
sgt 5
bct 0 0 1 1 0 0 0 0 0
bct 0 1 1 0 0 0 1 0 0
bct 0 2 1 0 1 0 0 0 0
bct 1 0 0 1 0 1 0 0 0
bct 1 1 0 1 0 0 0 0 0
bct 1 2 0 1 0 0 0 1 0
bct 2 0 0 0 0 0 1 0 0
bct 2 1 0 1 0 1 0 0 0
bct 2 2 0 0 0 0 0 0 0
bct 3 0 1 1 1 1 1 1 1
bct 3 1 1 1 1 1 1 1 1
bct 3 2 1 1 1 1 1 1 1
tna 2
pnw 5 1 1 1 1 TEST
pnw 1 2 2 2 1 TEST
pnw 2 2 1 3 1 TEST
pnw 2 0 0 4 1 TEST
bct 4 3 1 0 0 0 0 0 0